10.ox
.o........
.o....o.o.
ooo.o.oooo
...o..oo..
....ooo.o.
oooo.o..o.
o....o..o.
.o...o....
.o.o..oo..
.o...o..oo
